Root	root
"Aerococcaceae"	family
"Alicyclobacillaceae"	family
"Bacillaceae 1"	subfamily
"Bacillaceae 2"	subfamily
"Bacillaceae 2" Incertae Sedis	genus
"Bacilli Incertae Sedis"	genus
"Bacilli"	class
"Carnobacteriaceae 1"	subfamily
"Carnobacteriaceae 2"	subfamily
"Carnobacteriaceae"	family
"Clostridia"	class
"Clostridiaceae 1"	subfamily
"Enterococcaceae"	family
"Erysipelotrichales"	order
"Erysipelotrichi"	class
"Eubacteriaceae"	family
"Gracilibacteraceae"	family
"Heliobacteriaceae"	family
"Lachnospiraceae"	family
"Lachnospiraceae" Incertae Sedis	genus
"Lactobacillales"	order
"Leuconostocaceae"	family
"Listeriaceae"	family
"Paenibacillaceae 1"	subfamily
"Paenibacillaceae 2"	subfamily
"Paenibacillaceae"	family
"Peptostreptococcaceae"	family
"Peptostreptococcaceae" Incertae Sedis	genus
"Ruminococcaceae"	family
"Ruminococcaceae" Incertae Sedis	genus
"Sporolactobacillaceae Incertae Sedis"	genus
"Sporolactobacillaceae"	family
"Staphylococcaceae"	family
"Thermoactinomycetaceae"	family
"Thermoanaerobacteraceae"	family
"Thermoanaerobacterales"	order
"Thermoanaerobacterales" Incertae Sedis III	family
"Thermoanaerobacterales" Incertae Sedis IV	family
Abiotrophia	genus
Acaricomes	genus
Acetanaerobacterium	genus
Acetitomaculum	genus
Acetivibrio	genus
Acetobacter	genus
Acetobacteraceae	family
Acetobacterium	genus
Acetohalobium	genus
Acetonema	genus
Acholeplasma	genus
Acholeplasmataceae	family
Acholeplasmatales	order
Achromatium	genus
Achromobacter	genus
Acidaminobacter	genus
Acidaminococcus	genus
Acidianus	genus
Acidicaldus	genus
Acidilobus	genus
Acidimicrobiaceae	family
Acidimicrobiales	order
Acidimicrobidae	subclass
Acidimicrobineae	suborder
Acidimicrobium	genus
Acidiphilium	genus
Acidisphaera	genus
Acidithiobacillaceae	family
Acidithiobacillales	order
Acidithiobacillus	genus
Acidobacteria	phylum,class
Acidobacteriaceae	family
Acidobacteriales	order
Acidocella	genus
Acidomonas	genus
Acidothermaceae	family
Acidothermus	genus
Acidovorax	genus
Acinetobacter	genus
Acrocarpospora	genus
Actinoalloteichus	genus
Actinobacillus	genus
Actinobacteria	phylum,class
Actinobacteridae	subclass
Actinobaculum	genus
Actinocatenispora	genus
Actinocorallia	genus
Actinokineospora	genus
Actinomadura	genus
Actinomyces	genus
Actinomycetaceae	family
Actinomycetales	order
Actinomycineae	suborder
Actinoplanes	genus
Actinopolymorpha	genus
Actinopolyspora	genus
Actinospica	genus
Actinosynnema	genus
Actinosynnemataceae	family
Adhaeribacter	genus
Advenella	genus
Aequorivita	genus
Aeriscardovia	genus
Aerococcus	genus
Aeromicrobium	genus
Aeromonadaceae	family
Aeromonadales	order
Aeromonas	genus
Aeropyrum	genus
Aestuariibacter	genus
Afipia	genus
Agarivorans	genus
Aggregatibacter	genus
Agreia	genus
Agrobacterium	genus
Agrococcus	genus
Agromonas	genus
Agromyces	genus
Ahrensia	genus
Akkermansia	genus
Albibacter	genus
Albidovulum	genus
Alcaligenaceae	family
Alcaligenes	genus
Alcanivoraceae	family
Alcanivorax	genus
Algibacter	genus
Algicola	genus
Algoriphagus	genus
Alicycliphilus	genus
Alicyclobacillaceae Incertae Sedis	genus
Alicyclobacillus	genus
Alishewanella	genus
Alistipes	genus
Alkalibacillus	genus
Alkalibacter	genus
Alkalibacterium	genus
Alkaliflexus	genus
Alkalilimnicola	genus
Alkaliphilus	genus
Alkalispirillum	genus
Alkanindiges	genus
Allobaculum	genus
Allochromatium	genus
Allofustis	genus
Alloiococcus	genus
Allomonas	genus
Alphaproteobacteria	class
Alteromonadaceae	family
Alteromonadales	order
Alteromonadales Incertae Sedis	family
Alteromonas	genus
Alysiella	genus
Amaricoccus	genus
Aminobacter	genus
Aminobacterium	genus
Aminomonas	genus
Ammonifex	genus
Ammoniphilus	genus
Amphibacillus	genus
Amycolatopsis	genus
Anaeroarcus	genus
Anaerobacter	genus
Anaerobaculum	genus
Anaerobiospirillum	genus
Anaerobranca	genus
Anaerococcus	genus
Anaerofilum	genus
Anaerofustis	genus
Anaeroglobus	genus
Anaerolinaeceea	family
Anaerolinaeles	order
Anaerolinea	genus
Anaerolineae	class
Anaeromusa	genus
Anaeromyxobacter	genus
Anaerophaga	genus
Anaeroplasma	genus
Anaeroplasmataceae	family
Anaeroplasmatales	order
Anaerosinus	genus
Anaerostipes	genus
Anaerotruncus	genus
Anaerovorax	genus
Anaplasma	genus
Anaplasmataceae	family
Ancalomicrobium	genus
Ancylobacter	genus
Aneurinibacillus	genus
Angulomicrobium	genus
Anoxybacillus	genus
Anoxynatronum	genus
Antarctobacter	genus
Aquabacterium	genus
Aquamicrobium	genus
Aquaspirillum	genus
Aquicella	genus
Aquifex	genus
Aquificaceae	family
Aquificae	phylum,class
Aquificales	order
Aquificales Incertae Sedis	family
Aquiflexum	genus
Aquimarina	genus
Aquimonas	genus
Aquitalea	genus
Arcanobacterium	genus
Archaea	domain
Archaeoglobaceae	family
Archaeoglobales	order
Archaeoglobi	class
Archaeoglobus	genus
Archangium	genus
Arcicella	genus
Arcobacter	genus
Arenibacter	genus
Arhodomonas	genus
Arsenicicoccus	genus
Arsenophonus	genus
Arthrobacter	genus
Asaia	genus
Asanoa	genus
Asteroleplasma	genus
Asticcacaulis	genus
Atopobacter	genus
Atopobium	genus
Atopococcus	genus
Atopostipes	genus
Aurantimonadaceae	family
Aurantimonas	genus
Avibacterium	genus
Azoarcus	genus
Azohydromonas	genus
Azonexus	genus
Azorhizobium	genus
Azospira	genus
Azospirillum	genus
Azotobacter	genus
Azovibrio	genus
BRC1	phylum
BRC1_genera_incertae_sedis	genus
Bacillaceae	family
Bacillales	order
Bacillales Incertae Sedis XI	family
Bacillariophyta	genus
Bacilliales Incertae Sedis X	family
Bacilliales Incertae Sedis XII	family
Bacillus	supergenus
Bacillus I	genus
Bacillus a	genus
Bacillus b	genus
Bacillus c	genus
Bacillus d	genus
Bacillus e	genus
Bacillus f	genus
Bacillus g	genus
Bacillus h	genus
Bacillus j	genus
Bacillus k	genus
Bacteria	domain
Bacteriovoracaceae	family
Bacteriovorax	genus
Bacteroidaceae	family
Bacteroidales	order
Bacteroides	genus
Bacteroidetes	phylum,class
Balnearium	genus
Balneatrix	genus
Balneimonas	genus
Balneola	genus
Bangiophyceae	genus
Bartonella	genus
Bartonellaceae	family
Bdellovibrio	genus
Bdellovibrionaceae	family
Bdellovibrionales	order
Beggiatoa	genus
Beijerinckia	genus
Beijerinckiaceae	family
Belliella	genus
Belnapia	genus
Beneckea	genus
Bergeriella	genus
Bergeyella	genus
Betaproteobacteria	class
Beutenbergia	genus
Beutenbergiaceae	family
Bifidobacteriaceae	family
Bifidobacteriales	order
Bifidobacteriales Incertae Sedis	family
Bifidobacterium	genus
Bilophila	genus
Bizionia	genus
Blastobacter	genus
Blastochloris	genus
Blastococcus	genus
Blastomonas	genus
Blastopirellula	genus
Bordetella	genus
Borrelia	genus
Bosea	genus
Brachybacterium	genus
Brachymonas	genus
Brachyspira	genus
Brackiella	genus
Bradyrhizobiaceae	family
Bradyrhizobium	genus
Branhamella	genus
Brenneria	genus
Brevibacillus	genus
Brevibacteriaceae	family
Brevibacterium	genus
Brevinema	genus
Brevundimonas	genus
Brochothrix	genus
Brooklawnia	genus
Brucella	genus
Brucellaceae	family
Brumimicrobium	genus
Bryantella	genus
Buchnera	genus
Budvicia	genus
Bulleidia	genus
Burkholderia	genus
Burkholderiaceae	family
Burkholderiales	order
Burkholderiales Incertae Sedis	family
Buttiauxella	genus
Butyrivibrio	genus
Byssovorax	genus
Caedibacter	genus
Caenibacterium	genus
Caldanaerobacter	genus
Caldicellulosiruptor	genus
Caldilinea	genus
Caldilineacea	family
Caldilineae	subclass
Caldilineales	order
Caldimonas	genus
Caldisphaera	genus
Caldisphaeraceae	family
Caldisphaerales	order
Caldithrix	genus
Caldivirga	genus
Caloramator	genus
Caloranaerobacter	genus
Caminibacter	genus
Caminicella	genus
Campylobacter	genus
Campylobacteraceae	family
Campylobacterales	order
Candidatus Liberibacter	genus
Capnocytophaga	genus
Carboxydocella	genus
Carboxydothermus	genus
Cardinium	genus
Cardiobacteriaceae	family
Cardiobacteriales	order
Cardiobacterium	genus
Carnimonas	genus
Carnobacterium	genus
Caryophanon	genus
Castellaniella	genus
Catellatospora	genus
Catellibacterium	genus
Catenibacterium	genus
Catenulispora	genus
Catenulisporaceae	family
Catenuloplanes	genus
Catonella	genus
Caulobacter	genus
Caulobacteraceae	family
Caulobacterales	order
Cedecea	genus
Cellulomonadaceae	family
Cellulomonas	genus
Cellulophaga	genus
Cellulosimicrobium	genus
Cellvibrio	genus
Centipeda	genus
Cerasibacillus	genus
Cetobacterium	genus
Chelatococcus	genus
Chitinibacter	genus
Chitinimonas	genus
Chitinophaga	genus
Chlamydia	genus
Chlamydiaceae	family
Chlamydiae	phylum,class
Chlamydiales	order
Chlamydophila	genus
Chlorarachniophyceae	genus
Chlorobaculum	genus
Chlorobi	phylum
Chlorobia	class
Chlorobiaceae	family
Chlorobiales	order
Chlorobium	genus
Chloroflexaceae	family
Chloroflexales	order
Chloroflexi	phylum,class
Chloroflexus	genus
Chloroherpeton	genus
Chloronema	genus
Chlorophyta	genus
Chloroplast	family
Chondromyces	genus
Chromatiaceae	family
Chromatiales	order
Chromatium	genus
Chromobacterium	genus
Chromohalobacter	genus
Chryseobacterium	genus
Chryseomonas	genus
Chrysiogenaceae	family
Chrysiogenales	order
Chrysiogenes	genus
Chrysiogenetes	phylum,class
Citreicella	genus
Citricoccus	genus
Citrobacter	genus
Clavibacter	genus
Cloacibacterium	genus
Clostridiaceae	family
Clostridiaceae 2	subfamily
Clostridiaceae 2 Incertae Sedis	genus
Clostridiaceae 3	subfamily
Clostridiaceae 4	subfamily
Clostridiales	order
Clostridiales Incertae Sedis XI	family
Clostridiales Incertae Sedis XII	family
Clostridiales Incertae Sedis XIII	family
Clostridiales Incertae Sedis XIV	family
Clostridiales Incertae Sedis XV	family
Clostridiales Incertae Sedis XVI	family
Clostridiales Incertae Sedis XVII	family
Clostridiales Incertae Sedis XVIII	family
Clostridium	genus
Cobetia	genus
Coenonia	genus
Cohnella	genus
Collimonas	genus
Collinsella	genus
Colwellia	genus
Colwelliaceae	family
Comamonadaceae	family
Comamonas	genus
Conchiformibius	genus
Conexibacter	genus
Coprobacillus	genus
Coprococcus	genus
Coprothermobacter	genus
Corallococcus	genus
Coriobacteriaceae	family
Coriobacteriales	order
Coriobacteridae	subclass
Coriobacterineae	suborder
Coriobacterium	genus
Corynebacteriaceae	family
Corynebacterineae	suborder
Corynebacterium	genus
Costertonia	genus
Couchioplanes	genus
Coxiella	genus
Coxiellaceae	family
Craurococcus	genus
Crenarchaeota	phylum
Crenothrix	genus
Crenotrichaceae	family
Croceibacter	genus
Crocinitomix	genus
Crossiella	genus
Cryobacterium	genus
Cryomorpha	genus
Cryomorphaceae	family
Cryptanaerobacter	genus
Cryptobacterium	genus
Cryptomonadaceae	genus
Cryptosporangium	genus
Cupriavidus	genus
Curtobacterium	genus
Curvibacter	genus
Cyanobacteria	phylum,class
Cyclobacterium	genus
Cycloclasticus	genus
Cystobacter	genus
Cystobacteraceae	family
Cystobacterineae	suborder
Cytophaga	genus
Dactylosporangium	genus
Dechloromonas	genus
Deferribacter	genus
Deferribacteraceae	family
Deferribacterales	order
Deferribacterales Incertae Sedis	family
Deferribacteres	phylum,class
Defluvibacter	genus
Defluviicoccus	genus
Dehalobacter	genus
Dehalococcoides	phylum
Dehalococcoides_genera_incertae_sedis	genus
Deinococcaceae	family
Deinococcales	order
Deinococci	class
Deinococcus	genus
Deinococcus-Thermus	phylum
Delftia	genus
Deltaproteobacteria	class
Demetria	genus
Dendrosporobacter	genus
Denitratisoma	genus
Denitrobacterium	genus
Denitrovibrio	genus
Dermabacter	genus
Dermabacteraceae	family
Dermacoccaceae	family
Dermacoccus	genus
Dermatophilaceae	family
Dermatophilus	genus
Derxia	genus
Desemzia	genus
Desulfacinum	genus
Desulfarcales	order
Desulfarculaceae	family
Desulfarculus	genus
Desulfatibacillum	genus
Desulfitibacter	genus
Desulfitobacterium	genus
Desulfobacca	genus
Desulfobacter	genus
Desulfobacteraceae	family
Desulfobacterales	order
Desulfobacterium	genus
Desulfobacula	genus
Desulfobulbaceae	family
Desulfobulbus	genus
Desulfocapsa	genus
Desulfocella	genus
Desulfococcus	genus
Desulfofaba	genus
Desulfofrigus	genus
Desulfofustis	genus
Desulfohalobiaceae	family
Desulfohalobium	genus
Desulfomicrobiaceae	family
Desulfomicrobium	genus
Desulfomonile	genus
Desulfonatronovibrio	genus
Desulfonatronum	genus
Desulfonatronumaceae	family
Desulfonauticus	genus
Desulfonema	genus
Desulfonispora	genus
Desulforegula	genus
Desulforhabdus	genus
Desulforhopalus	genus
Desulfosarcina	genus
Desulfospira	genus
Desulfosporosinus	genus
Desulfotalea	genus
Desulfothermus	genus
Desulfotignum	genus
Desulfotomaculum	genus
Desulfovibrio	genus
Desulfovibrionaceae	family
Desulfovibrionales	order
Desulfurella	genus
Desulfurellaceae	family
Desulfurellales	order
Desulfurobacterium	genus
Desulfurococcaceae	family
Desulfurococcales	order
Desulfurococcus	genus
Desulfuromonaceae	family
Desulfuromonales	order
Desulfuromonas	genus
Desulfuromusa	genus
Dethiosulfovibrio	genus
Devosia	genus
Dialister	genus
Diaphorobacter	genus
Dichelobacter	genus
Dickeya	genus
Dictyoglomaceae	family
Dictyoglomales	order
Dictyoglomi	phylum,class
Dictyoglomus	genus
Dietzia	genus
Dietziaceae	family
Dinoroseobacter	genus
Dokdonella	genus
Dokdonia	genus
Dolosicoccus	genus
Dolosigranulum	genus
Donghaeana	genus
Dorea	genus
Duganella	genus
Dyadobacter	genus
Dyella	genus
Dysgonomonas	genus
Echinicola	genus
Ectothiorhodospira	genus
Ectothiorhodospiraceae	family
Edwardsiella	genus
Effluviibacter	genus
Eggerthella	genus
Ehrlichia	genus
Eikenella	genus
Elizabethkingia	genus
Empedobacter	genus
Emticicia	genus
Enhydrobacter	genus
Enhygromyxa	genus
Ensifer	genus
Enterobacter	genus
Enterobacteriaceae	family
Enterobacteriales	order
Enterococcus	genus
Enterovibrio	genus
Entomoplasma	genus
Entomoplasmataceae	family
Entomoplasmatales	order
Epilithonimonas	genus
Epsilonproteobacteria	class
Eremococcus	genus
Erwinia	genus
Erysipelothrix	genus
Erysipelotrichaceae	family
Erysipelotrichaceae Incertae Sedis	genus
Erythrobacter	genus
Erythromicrobium	genus
Escherichia	genus
Ethanoligenens	genus
Eubacterium	genus
Euglenida	genus
Euryarchaeota	phylum
Ewingella	genus
Exiguobacterium	genus
Fabibacter	genus
Facklamia	genus
Faecalibacterium	genus
Family I	family
Family II	family
Family III	family
Family IV	family
Family IX	family
Family V	family
Family VI	family
Family VII	family
Family VIII	family
Family X	family
Family XI	family
Family XII	family
Family XIII	family
Fastidiosipila	genus
Ferribacterium	genus
Ferrimonas	genus
Ferrimonidaceae	family
Ferroglobus	genus
Ferroplasma	genus
Ferroplasmataceae	family
Fervidobacterium	genus
Fibrobacter	genus
Fibrobacteraceae	family
Fibrobacterales	order
Fibrobacteres	phylum,class
Filifactor	genus
Filobacillus	genus
Filomicrobium	genus
Finegoldia	genus
Firmicutes	phylum
Flammeovirga	genus
Flammeovirgaceae	family
Flavimonas	genus
Flavobacteria	class
Flavobacteriaceae	family
Flavobacteriales	order
Flavobacterium	genus
Flectobacillus	genus
Flexibacter	genus
Flexibacteraceae	family
Flexistipes	genus
Flexithrix	genus
Fluoribacter	genus
Fluviicola	genus
Formivibrio	genus
Formosa	genus
Francisella	genus
Francisellaceae	family
Frankineae	suborder
Frateuria	genus
Friedmanniella	genus
Frigoribacterium	genus
Fulvimarina	genus
Fulvimonas	genus
Fusibacter	genus
Fusobacteria	phylum,class
Fusobacteriaceae	family
Fusobacteriales	order
Fusobacteriales Incertae Sedis	family
Fusobacterium	genus
Gaetbulibacter	genus
Gaetbulimicrobium	genus
Gallibacterium	genus
Gallicola	genus
Gallionella	genus
Gallionellaceae	family
Gammaproteobacteria	class
Garciella	genus
Gardnerella	genus
Gelidibacter	genus
Gelria	genus
Gemella	genus
Gemmata	genus
Gemmatimonadaceae	family
Gemmatimonadales	order
Gemmatimonadetes	phylum,class
Gemmatimonas	genus
Geobacillus	genus
Geobacter	genus
Geobacteraceae	family
Geodermatophilaceae	family
Geodermatophilus	genus
Geoglobus	genus
Geopsychrobacter	genus
Georgenia	genus
Geothermobacter	genus
Geotoga	genus
Geovibrio	genus
Giesbergeria	genus
Gillisia	genus
Glaciecola	genus
Globicatella	genus
Gluconacetobacter	genus
Gluconobacter	genus
Glycomyces	genus
Glycomycetaceae	family
Glycomycineae	suborder
Goodfellowia	genus
Gordonia	genus
Gordoniaceae	family
Gp1	genus
Gp10	genus
Gp11	genus
Gp12	genus
Gp13	genus
Gp14	genus
Gp15	genus
Gp16	genus
Gp17	genus
Gp18	genus
Gp19	genus
Gp2	genus
Gp20	genus
Gp21	genus
Gp22	genus
Gp23	genus
Gp24	genus
Gp25	genus
Gp26	genus
Gp3	genus
Gp4	genus
Gp5	genus
Gp6	genus
Gp7	genus
Gp8	genus
Gp9	genus
GpI	genus
GpIII	genus
GpIIa	genus
GpIIb	genus
GpIV	genus
GpIX	genus
GpV	genus
GpVI	genus
GpVII	genus
GpVIII	genus
GpX	genus
GpXI	genus
GpXII	genus
GpXIII	genus
Gracilibacillus	genus
Gracilibacter	genus
Gramella	genus
Granulicatella	genus
Grimontia	genus
Guggenheimella	genus
Gulosibacter	genus
Haemophilus	genus
Hafnia	genus
Hahella	genus
Hahellaceae	family
Halalkalicoccus	genus
Halanaerobacter	genus
Halanaerobiaceae	family
Halanaerobiales	order
Halanaerobium	genus
Haliangiaceae	family
Haliangium	genus
Haliscomenobacter	genus
Hallella	genus
Haloarcula	genus
Halobacillus	genus
Halobacteria	class
Halobacteriaceae	family
Halobacteriales	order
Halobacterium	genus
Halobacteroidaceae	family
Halobacteroides	genus
Halobiforma	genus
Halocella	genus
Halochromatium	genus
Halococcus	genus
Haloferax	genus
Halogeometricum	genus
Halolactibacillus	genus
Halomonadaceae	family
Halomonas	genus
Halonatronum	genus
Halorhabdus	genus
Halorhodospira	genus
Halorubrum	genus
Halosimplex	genus
Halospina	genus
Halostagnicola	genus
Haloterrigena	genus
Halothermothrix	genus
Halothiobacillaceae	family
Halothiobacillus	genus
Halovibrio	genus
Halovivax	genus
Helcococcus	genus
Helicobacter	genus
Helicobacteraceae	family
Heliobacterium	genus
Heliophilum	genus
Heliorestis	genus
Herbaspirillum	genus
Herbidospora	genus
Herminiimonas	genus
Herpetosiphon	genus
Herpetosiphonaceae	family
Herpetosiphonales	order
Hespellia	genus
Hippea	genus
Hirschia	genus
Histophilus	genus
Hoeflea	genus
Holdemania	genus
Holospora	genus
Holosporaceae	family
Hongiella	genus
Hydrocarboniphaga	genus
Hydrogenimonaceae	family
Hydrogenimonas	genus
Hydrogenivirga	genus
Hydrogenobacter	genus
Hydrogenobaculum	genus
Hydrogenophaga	genus
Hydrogenophilaceae	family
Hydrogenophilales	order
Hydrogenophilus	genus
Hydrogenovibrio	genus
Hylemonella	genus
Hymenobacter	genus
Hyperthermus	genus
Hyphomicrobiaceae	family
Hyphomicrobium	genus
Hyphomonas	genus
Ideonella	genus
Idiomarina	genus
Idiomarinaceae	family
Ignavigranum	genus
Ignicoccus	genus
Ignisphaera	genus
Ilyobacter	genus
Inquilinus	genus
Intrasporangiaceae	family
Intrasporangium	genus
Iodobacter	genus
Isobaculum	genus
Isochromatium	genus
Isoptericola	genus
Isosphaera	genus
Janibacter	genus
Jannaschia	genus
Janthinobacterium	genus
Jeotgalibacillus	genus
Jeotgalicoccus	genus
Jiangella	genus
Johnsonella	genus
Jonesia	genus
Jonesiaceae	family
Kaistella	genus
Kaistia	genus
Kangiella	genus
Kerstersia	genus
Ketogulonicigenium	genus
Kibdelosporangium	genus
Kineococcus	genus
Kineosphaera	genus
Kineosporia	genus
Kineosporiaceae	family
Kingella	genus
Kitasatospora	genus
Klebsiella	genus
Kluyvera	genus
Knoellia	genus
Kocuria	genus
Korarchaeota	phylum
Korarchaeota_genera_incertae_sedis	genus
Kordia	genus
Kordiimonadaceae	family
Kordiimonadales	order
Kordiimonas	genus
Kozakia	genus
Kribbella	genus
Krokinobacter	genus
Kurthia	genus
Kutzneria	genus
Kytococcus	genus
Labrys	genus
Laceyella	genus
Lachnobacterium	genus
Lachnospira	genus
Lacinutrix	genus
Lactobacillaceae	family
Lactobacillus	genus
Lactococcus	genus
Lactovum	genus
Lamprocystis	genus
Lampropedia	genus
Laribacter	genus
Larkinella	genus
Lawsonia	genus
Leadbetterella	genus
Lebetimonas	genus
Lechevalieria	genus
Leclercia	genus
Leeuwenhoekiella	genus
Legionella	genus
Legionellaceae	family
Legionellales	order
Leifsonia	genus
Leisingera	genus
Leminorella	genus
Lentibacillus	genus
Lentisphaera	genus
Lentisphaeraceae	family
Lentisphaerae	phylum,class
Lentisphaerales	order
Lentzea	genus
Leptolinea	genus
Leptonema	genus
Leptospira	genus
Leptospiraceae	family
Leptospirillum	genus
Leptothrix	genus
Leptotrichia	genus
Leucobacter	genus
Leuconostoc	genus
Leucothrix	genus
Levilinea	genus
Lewinella	genus
Limnobacter	genus
Listeria	genus
Listonella	genus
Loktanella	genus
Lonepinella	genus
Longispora	genus
Luteimonas	genus
Luteococcus	genus
Lutibacter	genus
Lysobacter	genus
Macrococcus	genus
Macromonas	genus
Magnetobacterium	genus
Magnetospirillum	genus
Mahella	genus
Malikia	genus
Malonomonas	genus
Mannheimia	genus
Maribacter	genus
Maricaulis	genus
Marichromatium	genus
Marinibacillus	genus
Marinicola	genus
Mariniflexile	genus
Marinilabilia	genus
Marinilactibacillus	genus
Marinimicrobium	genus
Marinithermus	genus
Marinitoga	genus
Marinobacter	genus
Marinobacterium	genus
Marinococcus	genus
Marinomonas	genus
Marinospirillum	genus
Marinovum	genus
Marmoricola	genus
Martelella	genus
Massilia	genus
Mechercharimyces	genus
Megamonas	genus
Meganema	genus
Megasphaera	genus
Meiothermus	genus
Melissococcus	genus
Melittangium	genus
Mesonia	genus
Mesoplasma	genus
Mesorhizobium	genus
Metallosphaera	genus
Methanimicrococcus	genus
Methanobacteria	class
Methanobacteriaceae	family
Methanobacteriales	order
Methanobacterium	genus
Methanobrevibacter	genus
Methanocalculus	genus
Methanocaldococcaceae	family
Methanocaldococcus	genus
Methanococcaceae	family
Methanococcales	order
Methanococci	class
Methanococcoides	genus
Methanococcus	genus
Methanocorpusculaceae	family
Methanocorpusculum	genus
Methanoculleus	genus
Methanofollis	genus
Methanogenium	genus
Methanohalobium	genus
Methanohalophilus	genus
Methanolobus	genus
Methanomethylovorans	genus
Methanomicrobia	class
Methanomicrobiaceae	family
Methanomicrobiales	order
Methanomicrobiales Incertae Sedis	family
Methanoplanus	genus
Methanopyraceae	family
Methanopyrales	order
Methanopyri	class
Methanopyrus	genus
Methanosaetaceae	family
Methanosarcina	genus
Methanosarcinaceae	family
Methanosarcinales	order
Methanosphaera	genus
Methanothermaceae	family
Methanothermobacter	genus
Methanothermococcus	genus
Methanothermus	genus
Methanothrix	genus
Methanotorris	genus
Methylarcula	genus
Methylibium	genus
Methylobacillus	genus
Methylobacter	genus
Methylobacteriaceae	family
Methylobacterium	genus
Methylocaldum	genus
Methylocapsa	genus
Methylocella	genus
Methylococcaceae	family
Methylococcales	order
Methylococcus	genus
Methylocystaceae	family
Methylocystis	genus
Methylohalobius	genus
Methylomicrobium	genus
Methylomonas	genus
Methylophaga	genus
Methylophilaceae	family
Methylophilales	order
Methylophilus	genus
Methylopila	genus
Methylorhabdus	genus
Methylosarcina	genus
Methylosinus	genus
Methylosphaera	genus
Methylothermus	genus
Methylovorus	genus
Microbacteriaceae	family
Microbacterium	genus
Microbispora	genus
Microbulbifer	genus
Microcella	genus
Micrococcaceae	family
Micrococcineae	suborder
Micrococcus	genus
Microlunatus	genus
Micromonospora	genus
Micromonosporaceae	family
Micromonosporineae	suborder
Micropolyspora	genus
Micropruina	genus
Microscilla	genus
Microtetraspora	genus
Microvirga	genus
Microvirgula	genus
Millisia	genus
Mitsuaria	genus
Mitsuokella	genus
Mobiluncus	genus
Modestobacter	genus
Moellerella	genus
Mogibacterium	genus
Mollicutes	class
Moorella	genus
Moraxella	genus
Moraxellaceae	family
Morganella	genus
Moritella	genus
Moritellaceae	family
Moryella	genus
Mucispirillum	genus
Muricauda	genus
Muricoccus	genus
Myceligenerans	genus
Mycetocola	genus
Mycobacteriaceae	family
Mycobacterium	genus
Mycoplana	genus
Mycoplasma	genus
Mycoplasmataceae	family
Mycoplasmatales	order
Myroides	genus
Myxococcaceae	family
Myxococcales	order
Myxococcus	genus
Nakamurella	genus
Nakamurellaceae	family
Nannocystaceae	family
Nannocystineae	suborder
Nanoarchaeum	phylum
Nanoarchaeum_genera_incertae_sedis	genus
Natrialba	genus
Natrinema	genus
Natroniella	genus
Natronincola	genus
Natronobacterium	genus
Natronococcus	genus
Natronolimnobius	genus
Natronorubrum	genus
Nautilia	genus
Nautiliaceae	family
Nautiliales	order
Naxibacter	genus
Neisseria	genus
Neisseriaceae	family
Neisseriales	order
Neochlamydia	genus
Neoehrlichia	genus
Neorickettsia	genus
Neptunomonas	genus
Nereida	genus
Nesiotobacter	genus
Nesterenkonia	genus
Nevskia	genus
Niastella	genus
Nicoletella	genus
Nitratifractor	genus
Nitratireductor	genus
Nitratiruptor	genus
Nitrincola	genus
Nitrobacter	genus
Nitrococcus	genus
Nitrosococcus	genus
Nitrosomonadaceae	family
Nitrosomonadales	order
Nitrosomonas	genus
Nitrosospira	genus
Nitrospina	genus
Nitrospinaceae	family
Nitrospira	phylum,class,genus
Nitrospiraceae	family
Nitrospirales	order
Nocardia	genus
Nocardiaceae	family
Nocardioidaceae	family
Nocardioides	genus
Nocardiopsaceae	family
Nocardiopsis	genus
Nonlabens	genus
Nonomuraea	genus
Novosphingobium	genus
OD1	phylum
OD1_genera_incertae_sedis	genus
OP10	phylum
OP10_genera_incertae_sedis	genus
OP11	phylum
OP11_genera_incertae_sedis	genus
Obesumbacterium	genus
Oceanibulbus	genus
Oceanicaulis	genus
Oceanicola	genus
Oceanimonas	genus
Oceanisphaera	genus
Oceanithermus	genus
Oceanobacillus	genus
Oceanobacter	genus
Oceanospirillaceae	family
Oceanospirillales	order
Oceanospirillum	genus
Ochrobactrum	genus
Octadecabacter	genus
Odyssella	genus
Oenococcus	genus
Oerskovia	genus
Okibacterium	genus
Oleiphilaceae	family
Oleiphilus	genus
Oleispira	genus
Oligella	genus
Oligotropha	genus
Olleya	genus
Olsenella	genus
Opitutaceae	family
Opitutus	genus
Orenia	genus
Oribacterium	genus
Orientia	genus
Ornithinicoccus	genus
Ornithinimicrobium	genus
Ornithobacterium	genus
Oryzihumus	genus
Oscillochloridaceae	family
Oscillochloris	genus
Ottowia	genus
Owenweeksia	genus
Oxalobacter	genus
Oxalobacteraceae	family
Oxalophagus	genus
Oxobacter	genus
Paenibacillus	genus
Palaeococcus	genus
Palleronia	genus
Paludibacter	genus
Pandoraea	genus
Pannonibacter	genus
Pantoea	genus
Papillibacter	genus
Parabacteroides	genus
Parachlamydia	genus
Parachlamydiaceae	family
Paracoccus	genus
Paracraurococcus	genus
Paralactobacillus	genus
Paraliobacillus	genus
Parascardovia	genus
Parasporobacterium	genus
Parvibaculum	genus
Parvimonas	genus
Parvularcula	genus
Parvularculaceae	family
Parvularculales	order
Pasteurella	genus
Pasteurellaceae	family
Pasteurellales	order
Pasteuriaceae Incertae Sedis	genus
Patulibacter	genus
Patulibacteraceae	family
Paucibacter	genus
Paucimonas	genus
Paucisalibacillus	genus
Pectinatus	genus
Pectobacterium	genus
Pediococcus	genus
Pedobacter	genus
Pedomicrobium	genus
Pelagibaca	genus
Pelistega	genus
Pelobacter	genus
Pelodictyon	genus
Pelomonas	genus
Pelospora	genus
Pelotomaculum	genus
Peptococcaceae	family
Peptococcaceae 1	subfamily
Peptococcaceae 2	subfamily
Peptococcus	genus
Peptoniphilus	genus
Peptostreptococcus	genus
Peredibacter	genus
Persephonella	genus
Persicivirga	genus
Persicobacter	genus
Petrimonas	genus
Petrobacter	genus
Petrotoga	genus
Phaeobacter	genus
Phaeospirillum	genus
Phenylobacterium	genus
Phlomobacter	genus
Phocoenobacter	genus
Photobacterium	genus
Photorhabdus	genus
Phyllobacteriaceae	family
Phyllobacterium	genus
Phytoplasma	genus
Pibocella	genus
Picrophilaceae	family
Picrophilus	genus
Pigmentiphaga	genus
Pilimelia	genus
Pirellula	genus
Piscirickettsia	genus
Piscirickettsiaceae	family
Planctomyces	genus
Planctomycetaceae	family
Planctomycetacia	class
Planctomycetales	order
Planctomycetes	phylum
Planifilum	genus
Planobispora	genus
Planococcaceae	family
Planococcus	genus
Planomicrobium	genus
Planomonospora	genus
Planotetraspora	genus
Plantibacter	genus
Pleomorphomonas	genus
Plesiocystis	genus
Plesiomonas	genus
Polaribacter	genus
Polaromonas	genus
Polyangiaceae	family
Polyangium	genus
Polymorphospora	genus
Polynucleobacter	genus
Pontibacillus	genus
Pontibacter	genus
Porphyrobacter	genus
Porphyromonadaceae	family
Porphyromonas	genus
Pragia	genus
Prauserella	genus
Prevotella	genus
Prevotellaceae	family
Procabacter	genus
Procabacteriaceae	family
Procabacteriales	order
Promicromonospora	genus
Promicromonosporaceae	family
Propionibacteriaceae	family
Propionibacterineae	suborder
Propionibacterium	genus
Propionicicella	genus
Propionicimonas	genus
Propioniferax	genus
Propionigenium	genus
Propionimicrobium	genus
Propionispira	genus
Propionispora	genus
Propionivibrio	genus
Prosthecobacter	genus
Prosthecochloris	genus
Prosthecomicrobium	genus
Proteiniphilum	genus
Proteobacteria	phylum
Proteus	genus
Providencia	genus
Pseudaminobacter	genus
Pseudidiomarina	genus
Pseudoalteromonadaceae	family
Pseudoalteromonas	genus
Pseudobutyrivibrio	genus
Pseudochrobactrum	genus
Pseudomonadaceae	family
Pseudomonadales	order
Pseudomonadales Incertae Sedis	family
Pseudomonas	genus
Pseudonocardia	genus
Pseudonocardiaceae	family
Pseudonocardineae	suborder
Pseudoramibacter	genus
Pseudorhodobacter	genus
Pseudospirillum	genus
Pseudovibrio	genus
Pseudoxanthomonas	genus
Psychrobacter	genus
Psychroflexus	genus
Psychromonadaceae	family
Psychromonas	genus
Psychroserpens	genus
Pullulanibacillus	genus
Pusillimonas	genus
Pyrobaculum	genus
Pyrococcus	genus
Pyrodictiaceae	family
Pyrodictium	genus
Pyrolobus	genus
Quadrisphaera	genus
Quatrionicoccus	genus
Rahnella	genus
Ralstonia	genus
Ramlibacter	genus
Raoultella	genus
Rarobacter	genus
Rarobacteraceae	family
Rathayibacter	genus
Reichenbachiella	genus
Reinekea	genus
Renibacterium	genus
Rhabdochlamydia	genus
Rhabdochromatium	genus
Rheinheimera	genus
Rhizobiaceae	family
Rhizobiales	order
Rhizobium	genus
Rhodanobacter	genus
Rhodobaca	genus
Rhodobacter	genus
Rhodobacteraceae	family
Rhodobacterales	order
Rhodobiaceae	family
Rhodobium	genus
Rhodoblastus	genus
Rhodocista	genus
Rhodococcus	genus
Rhodocyclaceae	family
Rhodocyclales	order
Rhodocyclus	genus
Rhodoferax	genus
Rhodoglobus	genus
Rhodomicrobium	genus
Rhodopila	genus
Rhodoplanes	genus
Rhodopseudomonas	genus
Rhodospira	genus
Rhodospirillaceae	family
Rhodospirillales	order
Rhodospirillum	genus
Rhodothalassium	genus
Rhodothermus	genus
Rhodovarius	genus
Rhodovibrio	genus
Rhodovulum	genus
Rickettsia	genus
Rickettsiaceae	family
Rickettsiales	order
Rickettsiales Incertae Sedis	family
Rickettsiella	genus
Riemerella	genus
Rikenella	genus
Rikenellaceae	family
Robiginitalea	genus
Roseateles	genus
Roseburia	genus
Roseibacterium	genus
Roseibium	genus
Roseicyclus	genus
Roseiflexus	genus
Roseinatronobacter	genus
Roseisalinus	genus
Roseivirga	genus
Roseivivax	genus
Roseobacter	genus
Roseococcus	genus
Roseomonas	genus
Roseospira	genus
Roseospirillum	genus
Roseovarius	genus
Rothia	genus
Rubellimicrobium	genus
Rubrimonas	genus
Rubritalea	genus
Rubritepida	genus
Rubrivivax	genus
Rubrobacter	genus
Rubrobacteraceae	family
Rubrobacterales	order
Rubrobacteridae	subclass
Rubrobacterineae	suborder
Ruegeria	genus
Ruminobacter	genus
Ruminococcus	genus
Runella	genus
SR1	phylum
SR1_genera_incertae_sedis	genus
Saccharibacter	genus
Saccharococcus	genus
Saccharomonospora	genus
Saccharophagus	genus
Saccharopolyspora	genus
Saccharospirillaceae	family
Saccharospirillum	genus
Saccharothrix	genus
Sagittula	genus
Salana	genus
Salegentibacter	genus
Salicola	genus
Salinibacter	genus
Salinibacterium	genus
Salinicoccus	genus
Salinimonas	genus
Salinisphaera	genus
Salinisphaeraceae	family
Salinisphaerales	order
Salinivibrio	genus
Salipiger	genus
Salmonella	genus
Samsonia	genus
Sandaracinobacter	genus
Sandarakinorhabdus	genus
Sandarakinotalea	genus
Sanguibacter	genus
Sanguibacteraceae	family
Saprospira	genus
Saprospiraceae	family
Sarcina	genus
Scardovia	genus
Schineria	genus
Schlegelella	genus
Sebaldella	genus
Sedimentibacter	genus
Sediminicola	genus
Segniliparaceae	family
Segniliparus	genus
Seinonella	genus
Sejongia	genus
Selenihalanaerobacter	genus
Selenomonas	genus
Serinicoccus	genus
Serpulinaceae	family
Serratia	genus
Shewanella	genus
Shewanellaceae	family
Shigella	genus
Shimazuella	genus
Shimia	genus
Shinella	genus
Shuttleworthia	genus
Silanimonas	genus
Silicibacter	genus
Silvimonas	genus
Simkania	genus
Simkaniaceae	family
Simonsiella	genus
Simplicispira	genus
Sinococcus	genus
Sinorhizobium	genus
Skermanella	genus
Skermania	genus
Slackia	genus
Smithella	genus
Sneathia	genus
Sodalis	genus
Soehngenia	genus
Solirubrobacter	genus
Sorangineae	suborder
Sorangium	genus
Sphaerobacter	genus
Sphaerobacteraceae	family
Sphaerobacterales	order
Sphaerobacteridae	subclass
Sphaerobacterineae	suborder
Sphaerotilus	genus
Sphingobacteria	class
Sphingobacteriaceae	family
Sphingobacteriales	order
Sphingobacterium	genus
Sphingobium	genus
Sphingomonadaceae	family
Sphingomonadales	order
Sphingomonas	genus
Sphingopyxis	genus
Sphingosinicella	genus
Spirillaceae	family
Spirilliplanes	genus
Spirillospora	genus
Spirillum	genus
Spirochaeta	genus
Spirochaetaceae	family
Spirochaetales	order
Spirochaetes	phylum,class
Spiroplasma	genus
Spiroplasmataceae	family
Spirosoma	genus
Sporacetigenium	genus
Sporanaerobacter	genus
Sporichthya	genus
Sporichthyaceae	family
Sporobacter	genus
Sporobacterium	genus
Sporocytophaga	genus
Sporohalobacter	genus
Sporolactobacillus	genus
Sporomusa	genus
Sporosarcina	genus
Sporotomaculum	genus
Stackebrandtia	genus
Staleya	genus
Staphylococcus	genus
Staphylothermus	genus
Stappia	genus
Starkeya	genus
Stella	genus
Stenothermobacter	genus
Stenotrophomonas	genus
Sterolibacterium	genus
Stetteria	genus
Stigmatella	genus
Streptacidiphilus	genus
Streptoalloteichus	genus
Streptobacillus	genus
Streptococcaceae	family
Streptococcus	genus
Streptomonospora	genus
Streptomyces	genus
Streptomycetaceae	family
Streptomycineae	suborder
Streptophyta	genus
Streptosporangiaceae	family
Streptosporangineae	suborder
Streptosporangium	genus
Stygiolobus	genus
Subdivision 3	family
Subdivision 3_genera_incertae_sedis	genus
Subdivision 5	family
Subdivision 5_genera_incertae_sedis	genus
Subdoligranulum	genus
Subsaxibacter	genus
Subsaximicrobium	genus
Subtercola	genus
Succiniclasticum	genus
Succinimonas	genus
Succinispira	genus
Succinivibrio	genus
Succinivibrionaceae	family
Sulfitobacter	genus
Sulfobacillus	genus
Sulfolobaceae	family
Sulfolobales	order
Sulfolobus	genus
Sulfophobococcus	genus
Sulfuricurvum	genus
Sulfurihydrogenibium	genus
Sulfurimonas	genus
Sulfurisphaera	genus
Sulfurivirga	genus
Sulfurospirillum	genus
Sulfurovum	genus
Sutterella	genus
Suttonella	genus
Swaminathania	genus
Symbiobacterium	genus
Synergistes	genus
Syntrophaceae	family
Syntrophobacter	genus
Syntrophobacteraceae	family
Syntrophobacterales	order
Syntrophococcus	genus
Syntrophomonadaceae	family
Syntrophomonas	genus
Syntrophospora	genus
Syntrophothermus	genus
Syntrophus	genus
TM7	phylum
TM7_genera_incertae_sedis	genus
Tannerella	genus
Tatlockia	genus
Tatumella	genus
Taylorella	genus
Teichococcus	genus
Telluria	genus
Tenacibaculum	genus
Tenericutes	phylum
Tenuibacillus	genus
Tepidibacter	genus
Tepidicella	genus
Tepidimonas	genus
Tepidiphilus	genus
Terasakiella	genus
Teredinibacter	genus
Terrabacter	genus
Terracoccus	genus
Terrimonas	genus
Tessaracoccus	genus
Tetragenococcus	genus
Tetrasphaera	genus
Tetrathiobacter	genus
Thalassobacillus	genus
Thalassobacter	genus
Thalassobius	genus
Thalassolituus	genus
Thalassomonas	genus
Thalassospira	genus
Thauera	genus
Thermaceae	family
Thermacetogenium	genus
Thermaerobacter	genus
Thermales	order
Thermanaeromonas	genus
Thermanaerovibrio	genus
Thermicanus	genus
Thermincola	genus
Thermithiobacillaceae	family
Thermithiobacillus	genus
Thermoactinomyces	genus
Thermoanaerobacter	genus
Thermoanaerobacterium	genus
Thermobacillus	genus
Thermobifida	genus
Thermobispora	genus
Thermobrachium	genus
Thermochromatium	genus
Thermocladium	genus
Thermococcaceae	family
Thermococcales	order
Thermococci	class
Thermococcus	genus
Thermocrinis	genus
Thermocrispum	genus
Thermodesulfatator	genus
Thermodesulfobacteria	phylum,class
Thermodesulfobacteriaceae	family
Thermodesulfobacteriales	order
Thermodesulfobacterium	genus
Thermodesulfobiaceae	family
Thermodesulfobium	genus
Thermodesulforhabdus	genus
Thermodesulfovibrio	genus
Thermodiscus	genus
Thermofilaceae	family
Thermofilum	genus
Thermohalobacter	genus
Thermoleophilum	genus
Thermomicrobia	phylum,class
Thermomicrobiaceae	family
Thermomicrobiales	order
Thermomicrobium	genus
Thermomonas	genus
Thermomonospora	genus
Thermomonosporaceae	family
Thermonema	genus
Thermoplasma	genus
Thermoplasmata	class
Thermoplasmataceae	family
Thermoplasmatales	order
Thermopolyspora	genus
Thermoproteaceae	family
Thermoproteales	order
Thermoprotei	class
Thermoproteus	genus
Thermosediminibacter	genus
Thermosipho	genus
Thermosphaera	genus
Thermosyntropha	genus
Thermothrix	genus
Thermotoga	genus
Thermotogaceae	family
Thermotogae	phylum,class
Thermotogales	order
Thermovenabulum	genus
Thermovibrio	genus
Thermus	genus
Thioalkalicoccus	genus
Thioalkalimicrobium	genus
Thioalkalispira	genus
Thioalkalivibrio	genus
Thiobaca	genus
Thiobacillus	genus
Thiobacter	genus
Thiocapsa	genus
Thioclava	genus
Thiococcus	genus
Thiocystis	genus
Thioflavicoccus	genus
Thiohalocapsa	genus
Thiolamprovum	genus
Thiomicrospira	genus
Thiomonas	genus
Thioploca	genus
Thioreductor	genus
Thiorhodococcus	genus
Thiorhodospira	genus
Thiorhodovibrio	genus
Thiothrix	genus
Thiotrichaceae	family
Thiotrichales	order
Thiovirga	genus
Thorsellia	genus
Tindallia	genus
Tissierella	genus
Tistrella	genus
Tolumonas	genus
Trabulsiella	genus
Treponema	genus
Trichlorobacter	genus
Trichococcus	genus
Tropheryma	genus
Truepera	genus
Trueperaceae	family
Tsukamurella	genus
Tsukamurellaceae	family
Tuberibacillus	genus
Turicella	genus
Turicibacter	genus
Turneriella	genus
Ulvibacter	genus
Ureaplasma	genus
Ureibacillus	genus
Uruburuella	genus
Vagococcus	genus
Varibaculum	genus
Variovorax	genus
Veillonella	genus
Veillonellaceae	family
Verrucomicrobia	phylum
Verrucomicrobiaceae	family
Verrucomicrobiaceae_genera_incertae_sedis	genus
Verrucomicrobiae	class
Verrucomicrobiales	order
Verrucomicrobium	genus
Verrucosispora	genus
Vibrio	genus
Vibrionaceae	family
Vibrionales	order
Victivallaceae	family
Victivallales	order
Victivallis	genus
Virgibacillus	genus
Virgisporangium	genus
Vitellibacter	genus
Vitreoscilla	genus
Vogesella	genus
Volucribacter	genus
Vulcanisaeta	genus
Vulcanithermus	genus
WS3	phylum
WS3_genera_incertae_sedis	genus
Waddlia	genus
Waddliaceae	family
Wautersia	genus
Weeksella	genus
Weissella	genus
Williamsia	genus
Williamsiaceae	family
Winogradskyella	genus
Wolbachia	genus
Wolinella	genus
Woodsholea	genus
Xanthobacter	genus
Xanthomonadaceae	family
Xanthomonadales	order
Xanthomonas	genus
Xenohaliotis	genus
Xenophilus	genus
Xenorhabdus	genus
Xiphinematobacter	genus
Xiphinematobacteriaceae	family
Xiphinematobacteriaceae_genera_incertae_sedis	genus
Xylanibacter	genus
Xylanibacterium	genus
Xylanimicrobium	genus
Xylanimonas	genus
Xylella	genus
Xylophilus	genus
Yangia	genus
Yania	genus
Yeosuana	genus
Yersinia	genus
Zimmermannella	genus
Zobellella	genus
Zobellia	genus
Zoogloea	genus
Zooshikella	genus
Zymobacter	genus
Zymomonas	genus
Zymophilus	genus
